NO     ./textures/blackstone256.xpm
SO    ./textures/blackstone256.xpm
WE ./textures/metalwindows256.xpm
EA ./textures/vitraux256.xpm
D dgfg


F 22,22,22

C 14,0,32

11111111          11111111
10000001111111111110000001
10000000000000000000000001
10000000000000000011111111
1000N00000000000001
1000000111111111111
11111111
