NO     ./textures/wall3.xpm
SO    ./textures/wall1.xpm
WE ./textures/wall4.xpm
EA ./textures/wall2.xpm


F 22,22,22

C 14,0,32

11111111
10000001
10000001
100N0001
10000001
10000001
11111111

11111111
10000001
10000001
100N0001
10000001
10000001
11111111
