NO     ./textures/wall3.xpm
SO    ./textures/wall1.xpm
WE ./textures/wall4.xpm
EA ./textures/wall2.xpm


F 22,22,22

C 14,0,32

11111110
1000N001
11111111
