NO     ./textures/wall3.xpm
SO    ./textures/wall1.xpm
WE ./textures/wall4.xpm
EA ./textures/wall2.xpm


F 22,22,22

C 60,0,0




11111111111111111111111111111
10000000001100000111011111111
11110111111111011100000010101
11110111111111011101010010101
11000000110101011100000000001
10000000100000000000000010001
10000000000000001101010010001
110000011101010111110111100N1
11110111 1110101 101111010001
11111111 1111111 111111111111
11111111111111111111111111111
11111111111111111111111111111
11111111111111111111111111111
11111111111111111111111111111
11111111111111111111111111111
11111111111111111111111111111
11111111111111111111111111111
11111111111111111111111111111
11111111111111111111111111111
11111111111111111111111111111
11111111111111111111111111111
11111111111111111111111111111
11111111111111111111111111111
11111111111111111111111111111
11111111111111111111111111111
11111111111111111111111111111
11111111111111111111111111111
11111111111111111111111111111
11111111111111111111111111111
11111111111111111111111111111
11111111111111111111111111111
11111111111111111111111111111
11111111111111111111111111111
11111111111111111111111111111
