NO     ./textures/blackstone256.xpm
SO    ./textures/blackstone256.xpm
WE ./textures/metalwindows256.xpm
EA ./textures/vitraux256.xpm
D dgfg


F 22,22,22

C 14,0,32

1   11111111111111111
11   1000000000000001
101   100000111000001
1001   100000000E0001
10001   1000000000001
100001   100000000001
1111111   11111111111
