NO     ./textures/blackstone256.xpm
SO    ./textures/blackstone256.xpm
WE ./textures/metalwindows256.xpm
EA ./textures/vitraux256.xpm


F 22,22,22

C 14,0,32

11111111
1000N001
11111011
