NO     ./textures/wall1.xpm
SO    ./textures/rideaux.xpm
WE ./textures/rideaux.xpm
EA ./textures/rideaux.xpm


F 100,100,100

C 100,255,100




11111111111111111111111111111
10000000001100000111011111111
11110111111111011100000010001
11110111111111011101010010001
11000000110101011100000010001
10000000100000000000000010001
10000000000000001101010000001
110000011101010111110111100N1
11110111 1110101 101111010001
11111111 1111111 111111111111
11111111111111111111111111111
11111111111111111111111111111
11111111111111111111111111111
11111111111111111111111111111
11111111111111111111111111111
11111111111111111111111111111
11111111111111111111111111111
11111111111111111111111111111
11111111111111111111111111111
11111111111111111111111111111
11111111111111111111111111111
11111111111111111111111111111
11111111111111111111111111111
11111111111111111111111111111
11111111111111111111111111111
11111111111111111111111111111
11111111111111111111111111111
11111111111111111111111111111
11111111111111111111111111111
11111111111111111111111111111
11111111111111111111111111111
11111111111111111111111111111
11111111111111111111111111111
11111111111111111111111111111
